OpenWeather	KEYWORD1
Weather	KEYWORD1

longitude	KEYWORD2
latitude	KEYWORD2
weather_id	KEYWORD2
weather_main	KEYWORD2
weather_description	KEYWORD2
weather_icon	KEYWORD2
temp	KEYWORD2
temp_max	KEYWORD2
temp_min	KEYWORD2
pressure	KEYWORD2
humidity	KEYWORD2
visibility	KEYWORD2
wind_speed	KEYWORD2
wind_direction	KEYWORD2
clouds	KEYWORD2
rain_1h	KEYWORD2
rain_3h	KEYWORD2
snow_1h	KEYWORD2
snow_3h	KEYWORD2
sunrise	KEYWORD2
sunset	KEYWORD2
country	KEYWORD2
timezone	KEYWORD2
city_name	KEYWORD2
city_id	KEYWORD2
data_time	KEYWORD2
units	KEYWORD2

default_	LITERAL1
metric	LITERAL1
imperial	LITERAL1

key	KEYWORD2
getWeatherByCityName	KEYWORD2
getWeatherByID	KEYWORD2
getWeatherByZIP	KEYWORD2
getWeatherByCoords	KEYWORD2